11111111111111111111111111111111111111111111111111111111111111111
10000000000000000000000000000000000000000000000000000000000000001
10000000000000000000000000000000000000000000000000000000000000001
10000000000000000000000000000000000000000000000000000000000000001
10000000000001100100100100100111111111111111111111100000000000001
10000000000101100000000000000000000000000000000011100000000000001
10000000010101100000000000000000000000000000000011111111100000001
10000001010101100000000000000000000000000000000011111111100000001
11110001111111100000000000000000000000000000000000111111111111001
10000000000000000000000000000000000000000000000000000000000000011
10000000000000000000000000001111111001001001001100000000000001111
10000000001111000000000001001111111001001001001110000000000111111
10000000001111000000001001001111111001001001001111000000011111111
10001111100000011111001001001111111001001001001111111111111111111
11111111111111111111111111111111111111111111111111111111111111111